NO ./asset/images/NO.xpm
SO ./asset/images/SO.xpm
DO ./asset/images/DOOR.xpm
F 127,127,127
C 255,255,0
IT ./asset/images/ITEM.xpm
WE ./asset/images/WE.xpm
EA ./asset/images/EA.xpm

 1111
1E0D01
 1111